응용 분야	관련 산업
소리	 
음성 인식	인터페이스, 자동차, 방범, IoT
음성 검색	헤드폰, 통신
감정 분석	고객관리 (CRM)
엔진 이상 탐지	자동차, 항공
사기 탐지	금융, 카드
 	 
시계열 데이터	 
로그 분석/위험 탐지	데이터 센터, 보안, 금융
기업 리소스 설계	생산, 자동차, 유통
센서 기반 예측 분석	IoT, 스마트 가전, 하드웨어 생산
경영/경제 분석	금융, 회계, 정부
추천 엔진	E-커머스, 미디어, 소셜 네트워크
 	 
텍스트	 
감정 분석	고객관리, 소셜미디어, 홍보
검색, 주제 탐지	금융
위험 탐지	소셜 미디어, 정부
사기 탐지	보험, 금융
 	 
이미지	 
얼굴 인식	 
이미지 검색	소셜 미디어, 검색
머신 비전	자동차, 항공
사진 군집화	통신, 헤드셋
 	 
비디오	 
행동 인식	게임, 인터페이스
실시간 위험 탐지	보안, 공항
